t s s s s s s s s s s s s s s s s s t
t h r r r r r r r k r r r r r r r h t
t g a g g g g g g g g g g g g g a g t
t g r g g g g g g g g g g g g g r g t
s g r g g g g g g g g g g g g g r g s
s g r g g g g g g g g g g g g g r g s
s g r g g g g g g g g g g g g g r g s
t g r g g g g g g g g g g g g g r g t
t g r g g g g g g g g g g g g g r g t
t g r g g g g g g g g g g g g g r g t
m v r v v v v v v v v v v v v v r v m
t g r g g g g g g g g g g g g g r g t
t g r g g g g g g g g g g g g g r g t
s g r g g g g g g g g g g g g g r g s
s g r g g g g g g g g g g g g g r g s
s g r g g g g g g g g g g g g g r g s
t g r g g g g g g g g g g g g g r g t
t g a g g g g g g g g g g g g g a g t
t h r r r r r r r k r r r r r r r h t
t s s s s s s s s s s s s s s s s s t
