t s s s s s s s s s s s s s s s s l l
t h g g g g g g g k g g g g g g g h t
t g a g g g g g g g g g g g g g a g t
t g g g g g g g g g g g g g g g g g t
s g g g g g g g g g g g g g g g g g s
s g g g g g g g g g g g g g g g g g s
s g g g g g g g g g g g g g g g g g s
t g g g g g g g g g g g g g g g g g t
t g g g g g g g g g g g g g g g g g t
t g g g g g g g g g g g g g g g g g t
m v r v v v v v v v v v v v v v r v m
t g g g g g g g g g g g g g g g g g t
t g g g g g g g g g g g g g g g g g t
s g g g g g g g g g g g g g g g g g s
s g g g g g g g g g g g g g g g g g s
s g g g g g g g g g g g g g g g g g s
t g g g g g g g g g g g g g g g g g t
t g a g g g g g g g g g g g g g a g t
t h g g g g g g g k g g g g g g g h t
t s s s s s s s s s s s s s s s s s t
